ronaldo	ronaldo
7	7
seacrest	seacrest
beach	beach
ballys	ballys
station	station
entrance	entrance
carp	carp
team	team
ebizu	ebizu
daily	daily
imperial	imperial
college	college
london	london
academy	academy
entrance	entrance
18	18
78	78
nil	nil
satis	satis
nisi	nisi
optimum	optimum
everton	everton
arshavin	prshavia
23	23
bierhoff	bierhoff
20	20
acm	acm
1899	1899
west	west
ham	ham
united	united
arsenal	arsenal
foot	foot
ball	ball
club	club
since	since
1886	1886
le	le
grove	grove
1	1
walcott	walcott
14	14
arsenal	arsenal
arteta	arteta
6	6
joachim	joachim
12	12
knight	knight
16	16
baker	baker
32	32
aston	aston
villa	villa
ballack	ballack
13	13
starbucks	sarrbuck
coffee	coffee
samsung	samsung
mobile	mobile
chelsea	chelsea
football	football
club	club
chelsea	chelsea
football	football
club	club
essien	essien
5	5
terry	terry
26	26
donovan	donovan
9	9
arteta	arteta
6	6
chelsea	chelsea
football	football
club	out
torres	torres
9	c
chelsea	chelsea
football	football
club	club
chelsea	chelsea
jarrett	jarrett
gembira	gembira
loka	loka
avilon	avilon
celebrating	celebrating
life	life
il	il
mercato	mercato
vacation	vacation
vinyl	vinyl
newcastle	newcastle
united	united
stubhub	stubhub
12	12
vpersie	vpersif
20	20
manchester	manchester
united	united
southampton	southampton
publick	publick
house	house
burton	burton
ipa	ipa
long	long
islands	islands
original	original
craft	craft
brewery	brewery
lundekvam	lundekiam
5	5
allahabad	allahabad
university	university
quot	quot
rami	rami
tot	tot
arbores	arbores
start	start
finish	finish
friendship	friendship
tottenham	tottenham
1st	iii
nvidia	nvidia
meant	meant
to	to
be	be
played	played
west	west
ham	ham
united	united
nani	nan
west	west
ham	ham
west	west
ham	ham
united	united
wigan	wigan
athletic	athletic
heinz	heinz
baked	baked
beanz	beanz
1869	1869
in	in
tomato	tomato
sauce	sauce
estd	estp
estd	estp
wigan	wigan
1932	1932
athletic	athletic
west	west
bromwich	bromwich
albion	albion
lest	lest
we	we
forget	forget
bridgestone	bridgestone
tokyo	tokyo
disneyland	disneyland
20	evrend
years	years
the	the
kingdom	kingdom
of	of
dreams	dreams
macic	macic
christmas	christmas
2003	2003
fantasy	fauors
denver	denver
beer	beer
co	co
afcea	afcea
nova	nova
naval	naval
it	it
day	day
bmw	bmw
hutchinson	hutchinson
the	the
scottish	scottish
salmon	oimon
company	company
chathamkent	coynthammelly
police	police
to	to
serve	serve
and	and
protect	protect
scotts	scotts
family	family
italian	italian
cuisine	cuisine
bar	bar
maples	maples
tavern	tavern
est	est
2011	2011
crocodiles	crocodiles
no	no
swimming	swimming
welcome	welcome
to	to
historic	historic
battery	battery
point	point
oldtown	oldtown
white	white
coffee	coffee
oldtown	oldtown
white	white
coffee	coffee
restaurant	restaurant
bar	bar
singhs	singhs
caribbean	caribbean
cuisine	cuisine
michelin	michelin
mod	mod
tm	tm
flying	flying
horses	horses
americas	americas
oldest	oldest
carousel	carousel
national	national
register	register
of	of
historic	historic
places	places
le	le
grenier	grenier
a	a
pain	pain
10000	10000
business	business
invest	invest
2012	2012
campaign	campaign
wwwbusinessinvestcouk	wwwbusinessinvestcouk
kolind	kolind
koreskole	foreskole
north	north
union	union
wildcats	wildcats
chinese	chinese
food	food
open	open
eat	eat
in	in
take	take
out	out
police	police
station	station
the	the
table	table
barbeque	barbredde
people	people
handmade	handmade
chocolates	chocolates
aishahaleyesblogspotcom	aishahaleycshlogspotcom
exclusive	exclusive
to	to
cadbury	cadbury
world	world
dairy	dairy
milk	milk
smooth	smooth
chocolate	chocolate
mousse	mousse
starbucks	carblccks
coffee	coffee
kia	know
motors	mosess
halal	halal
star	star
welcome	welcome
snack	snack
tagine	tagine
cobra	cobra
show	show
thailand	thailand
frikkie	frikkie
du	du
toit	tor
safaris	safaris
